1111111111111111
10010E00000C0001
1000011111011101
10011P00000111C1
1111111111111111